30
20
13 13 13 13 13 13 13 13 13 13 13 13 13 13 13 13 13 13 13 13 13 13 13 13 13 13 13 13 13 13
13 11 11 11 11 13 13 11 11 11 11 11 11 11 13 11 11 11 11 11 13 11 13 13 13 13 13 13 13 13
13 4 14 7 0 0 13 0 0 0 0 0 0 2 11 0 0 0 0 0 11 0 11 11 11 13 11 11 11 13
13 14 7 0 4 14 13 5 2 2 0 0 4 14 7 0 0 0 0 2 2 0 0 0 2 11 0 0 0 13
13 11 0 4 14 13 13 14 14 14 5 6 14 13 5 0 0 0 4 14 14 7 0 4 14 7 0 0 0 13
13 5 0 14 13 0 0 0 13 13 14 7 0 13 14 7 0 4 14 13 5 2 4 14 13 0 0 0 0 13
13 14 5 2 0 0 0 0 0 13 0 0 0 0 13 5 4 14 13 13 14 14 14 13 5 0 0 0 0 13
13 13 14 14 5 0 0 0 0 13 6 14 7 0 13 13 13 13 11 11 11 11 11 13 14 7 0 0 0 13
13 13 13 13 14 7 0 0 4 13 5 0 0 4 13 13 11 11 0 0 0 0 0 11 2 2 2 2 4 13
13 13 0 2 2 2 2 4 14 13 13 7 6 14 13 11 0 0 0 0 0 0 0 6 14 14 14 14 14 13
13 11 4 14 14 14 14 14 13 0 0 0 0 0 13 5 2 0 0 0 0 0 0 0 13 11 11 11 11 13
13 0 13 13 0 0 0 2 2 2 2 4 14 7 13 14 14 5 2 2 2 2 2 0 11 0 0 0 0 13
13 0 13 5 0 0 6 13 13 13 13 13 13 0 2 13 13 14 14 14 14 14 14 7 0 0 0 0 0 13
13 0 13 14 5 2 2 2 0 0 0 0 13 5 13 13 11 11 2 4 13 13 5 0 0 0 0 0 0 13
13 0 11 13 14 14 14 14 5 0 2 0 13 13 13 11 0 6 14 14 13 13 14 5 2 2 2 0 2 13
13 0 0 11 2 0 0 6 14 6 14 4 13 13 13 0 0 0 11 11 11 11 13 14 14 14 14 7 14 13
13 0 0 4 14 5 0 0 2 4 13 14 13 11 13 0 0 0 0 0 0 0 13 11 11 11 11 0 0 13
13 0 6 14 13 14 5 4 14 14 13 11 11 0 11 6 14 14 14 14 14 7 11 0 0 0 0 0 0 13
13 5 2 2 13 13 14 14 13 13 5 2 2 2 2 2 4 13 2 2 2 4 13 13 5 2 2 2 4 13
13 14 14 14 13 13 13 13 13 13 14 14 14 14 14 14 14 13 14 14 14 14 13 13 14 14 14 14 14 13
